 , , , , , , , , , , , , , , , , , , , 
 , , , , , , , ,K,K,K,K, , , , , , , , 
 , , , , , , , ,K,K,K,K, , , , , , , , 
 , , , , , , , ,K,K,K,K, , , , , , , , 
 , , , , , , , ,K,K,K,K, , , , , , , , 
 , , ,C,C,C, , , , , , , , ,C,C,C, , , 
 , , ,C,C,C, , , , , , , , ,C,C,C, , , 
 , , ,C,C,C, , , , , , , , ,C,C,C, , , 
 , , , , , , , , , , , , , , , , , , , 
 , , , , , , , , , , , , , , , , , , , 
 , , , , , , , , , , , , , , , , , , , 
 , , , , , , , , , , , , , , , , , , , 
 , , , , , , , , , , , , , , , , , , , 
 , , , , , , , , , , , , , , , , , , , 
 , , , , , , , , , , , , , , , , , , , 
 , , , , , , , , , , , , , , , , , , , 
w,w,w,b,b,w,w,w,w,w,w,w,w,w,w,b,b,w,w,w
w,w,w,b,b,w,w,w,w,w,w,w,w,w,w,b,b,w,w,w
 , , , , , , , , , , , , , , , , , , , 
 , , , , , , , , , , , , , , , , , , , 
 , , , , , , , , , , , , , , , , , , , 
 , , , , , , , , , , , , , , , , , , , 
 , , , , , , , , , , , , , , , , , , , 
 , , , , , , , , , , , , , , , , , , , 
 , , , , , , , , , , , , , , , , , , , 
 , , , , , , , , , , , , , , , , , , , 
 , , ,C,C,C, , , , , , , , ,C,C,C, , , 
 , , ,C,C,C, , , , , , , , ,C,C,C, , , 
 , , ,C,C,C, , , , , , , , ,C,C,C, , , 
 , , , , , , , ,K,K,K,K, , , , , , , , 
 , , , , , , , ,K,K,K,K, , , , , , , , 
 , , , , , , , ,K,K,K,K, , , , , , , , 
 , , , , , , , ,K,K,K,K, , , , , , , , 
 , , , , , , , , , , , , , , , , , , , 